.........................
...#.....................
...##......#####....#....
...#######.#...#....#....
...######..#.#.#...###...
.###.##....#.#.#...###...
.###.##..###.#.#...###.^.
.#...##.....&&.#.........
###..##..###.#.###.......
.#...@.......#...........
........>....#####.......