.........................
...#.....................
...##......#####....#....
...#########...#....#....
...######..#.#.#...###...
.###.##....#.#.#...###...
.###.##..###.#.#..####.>.
.#...##.....&&.#..#......
.##..##..###.#.###.......
.#...@.......#...........
f#......>....#####.......